_E_____________
_             _
_ ___________9_
_   ________  _
_ _ _         _
_7_ _______ _6_
_          __ _
_ ________5   _
_ ________ __ _
_          _  _ 
____________I__